+--+--+--+--+--+--+--+--+--+--+
|p          |  |              |
+  +  +--+  +  +--+--+--+--+  +
|  |     |  |                 |
+  +--+  +  +--+--+--+--+--+  +
|  |     |           |     |  |
+  +  +--+  +--+--+--+  +  +  +
|  |  |     |           |     |
+--+  +  +--+  +--+--+--+--+--+
|     |  |     |        |     |
+  +--+--+  +--+  +--+--+  +  +
|  |     |  |              |  |
+  +  +  +  +  +--+--+--+  +  +
|     |  |  |  |        |  |  |
+--+--+  +  +--+  +--+  +  +  +
|        |  |     |     |  |  |
+  +--+--+  +  +--+--+  +--+  +
|  |     |  |        |  |     |
+  +  +  +  +--+--+  +  +  +  +
|     |              |     | g|
+--+--+--+--+--+--+--+--+--+--+